block_id treecode lvl neighbors lvl
    1      003    3    3  3  3  3  3  3  4  3 
    2      023    3    3  3  3  4  3  4  3  4  4 
    3      0303   4    4  4  4  4  4  4  4  4 
    4      0313   4    4  4  4  4  4  4  4  4  4 
    5      013    3    3  3  3  3  3  4  4  4  4 
    6      1203   4    4  4  4  4  4  4  4  4  4 
    7      1213   4    4  3  4  4  3  4  3  4 
    8      1303   3    3  3  3  3  3  3  4  3 
    9      103    3    3  3  3  3  3  3  4  4  4 
   10      1313   3    3  4  3  3  3  4  3 
   11      000    3    3  3  3  3  3  3  3  3 
   12      001    3    3  3  3  3  3  3  3  3 
   13      113    3    3  3  3  3  3  3  3  3  3 
   14      002    3    3  3  3  3  3  3  3  3 
   15      020    3    3  3  3  3  3  3  4  3  3 
   16      021    3    3  3  3  3  3  4  3  4  4 
   17      022    3    3  3  3  3  3  3  3  4  4 
   18      0300   4    4  4  3  4  3  3 
   19      0301   4    4  4  4  3  4  4  3 
   20      0302   4    4  4  4  4  4  3  3 
   21      0310   4    4  4  4  3  4  4  3 
   22      0311   4    4  4  4  3  4  4  3 
   23      0312   4    4  4  4  4  4  4  4  4  4 
   24      010    3    3  3  3  3  3  3  3  3 
   25      011    3    3  3  3  3  3  3  3  3 
   26      012    3    3  3  3  3  3  4  3  4  4 
   27      1200   4    4  4  4  3  4  4  3 
   28      1201   4    4  4  4  3  4  4  3 
   29      1202   4    4  4  4  4  4  4  4  4  4 
   30      1210   4    4  4  4  3  4  4  3 
   31      1211   4    3  4  4  3  3  4  3 
   32      1212   4    4  4  4  4  4  4  4  4 
   33      1300   3    3  3  4  3  3  4  3 
   34      1301   3    3  3  3  3  3  3  3 
   35      1302   3    3  3  3  4  3  4  3  4 
   36      100    3    3  3  3  3  3  3  3  3 
   37      101    3    3  3  3  3  3  3  3  3 
   38      102    3    3  3  3  3  3  4  4  4  4 
   39      1310   3    3  3  3  3  3  3  3 
   40      1311   3    3  3  3  3  3  3 
   41      1312   3    3  3  4  3  3  3  4  3 
   42      110    3    3  3  3  3  3  3  3  3 
   43      111    3    3  3  3  3  3  3  3  3 
   44      112    3    3  3  3  3  3  3  4  3  3 
 1026      03300  4    4  4  4  4  4  4 
 1027      03301  4    4  4  4  4  4  4  4 
 1028      03302  4    4  4  5  4  5  4  4 
 1029      03310  4    4  4  4  4  4  4  4 
 1030      03311  4    4  4  4  4  4  4  4 
 1031      03312  4    4  4  5  4  4  4  5  5 
 1032      12200  4    4  4  4  4  4  4  4 
 1033      12201  4    4  4  4  4  4  4  4 
 1034      12202  4    4  4  5  4  4  4  5  5 
 1035      12210  4    4  4  4  4  4  4  4 
 1036      12211  4    4  4  4  4  4  4 
 1037      12212  4    4  4  5  4  4  4  5  5 
 1038      1230   4    4  4  4  4  4  4  5  4  4 
 1039      1231   4    4  3  4  4  3  4  3  4 
 1040      1232   4    4  4  4  4  4  4  5  5  5 
 1041      1320   3    3  3  3  4  3  4  3  4 
 1042      1321   3    3  4  3  3  3  3  4  3 
 1043      1322   3    3  3  4  3  4  4  3 
 1044      1330   4    3  4  4  3  3  3  4  3 
 1045      1331   4    3  4  4  3  3  4  3 
 1046      1332   4    4  4  3  4  3  3  3 
 1047      03320  5    4  5  5  4  4  5  4 
 1048      03321  5    4  5  5  5  4  4  5  5 
 1049      03322  5    5  5  5  5  5  4  4 
 1050      03330  5    4  5  5  5  4  4  5  5 
 1051      03331  5    4  5  5  5  4  4  5  5 
 1052      03332  5    5  5  5  5  5  5  5  5 
 1053      12220  5    4  5  5  5  4  4  5  5 
 1054      12221  5    4  5  5  5  4  4  5  5 
 1055      12222  5    5  5  5  5  5  5  5  5 
 1056      12230  5    4  5  5  5  4  4  5  5 
 1057      12231  5    4  5  5  4  4  5  4 
 1058      12232  5    5  5  5  5  5  5  5  5 
 1064      03303  4    4  4  5  4  4  4  5  5 
 1065      03313  4    4  4  5  4  4  4  5  5 
 1066      12203  4    4  4  5  4  4  4  5  5 
 1067      12213  4    4  5  4  4  4  5  4 
 1068      1233   4    4  3  4  4  3  4  3  4 
 1070      1323   3    3  4  3  4  3  3  3 
 1072      1333   4    4  4  4  3  3  3 
 1080      03323  5    5  5  5  5  5  5  5  5 
 1081      03333  5    5  5  5  5  5  5  5  5 
 1082      12223  5    5  5  5  5  5  5  5  5 
 1083      12233  5    5  5  5  5  4  5  4 
 2051      2100   4    4  4  4  4  3  4  3 
 2052      2101   4    4  4  4  5  4  4  4  5  5 
 2053      2102   4    4  4  4  4  4  3  3 
 2054      21100  5    5  5  5  5  4  5  4 
 2055      2103   4    4  4  4  5  4  4  4  4  4 
 2056      21101  5    5  5  5  5  5  5  5  5 
 2057      21103  5    5  5  4  5  5  5  4  4 
 2058      21113  5    5  5  4  5  5  5  4  4 
 2059      30003  5    5  5  4  5  5  5  4  4 
 2060      30013  5    5  4  5  5  4  4  4 
 2061      3013   4    4  4  4  4  3  4  3 
 2062      21102  5    5  5  4  5  4  4  4 
 2063      21110  5    5  5  5  5  5  5  5  5 
 2064      21111  5    5  5  5  5  5  5  5  5 
 2065      21112  5    5  5  4  5  5  5  4  4 
 2066      30000  5    5  5  5  5  5  5  5  5 
 2067      30001  5    5  5  5  5  5  5  5  5 
 2068      30002  5    5  5  4  5  5  5  4  4 
 2069      30010  5    5  5  5  5  5  5  5  5 
 2070      30011  5    5  5  5  4  5  5  4 
 2071      30012  5    5  5  4  5  5  5  4  4 
 2072      3010   4    4  4  4  4  5  4  4  5  5 
 2073      21123  4    4  4  4  4  4  4  4 
 2074      21133  4    4  4  4  4  4  4  4 
 2075      30023  4    4  4  4  4  4  4  4 
 2076      30033  4    4  4  4  4  4  4 
 2077      3011   4    4  4  4  3  4  4  3 
 2078      3012   4    4  4  4  4  5  4  4  4  4 
 2079      21120  4    5  4  4  5  4  4  4 
 2080      21121  4    5  4  4  4  5  5  4  4 
 2081      21122  4    4  4  4  4  4  4 
 2082      21130  4    5  4  4  4  5  5  4  4 
 2083      21131  4    5  4  4  4  5  5  4  4 
 2084      21132  4    4  4  4  4  4  4  4 
 2085      30020  4    5  4  4  4  5  5  4  4 
 2086      30021  4    5  4  4  4  5  5  4  4 
 2087      30022  4    4  4  4  4  4  4  4 
 2088      30030  4    5  4  4  4  5  5  4  4 
 2089      30031  4    5  4  4  4  5  4  4 
 2090      30032  4    4  4  4  4  4  4  4 
 2091      3030   4    4  4  4  4  4  4  4  4 
 2092      3031   4    4  4  4  3  4  4  3 
 2093      3033   4    4  4  4  3  3  3 
 2094      3032   4    4  4  4  4  4  3  3 
 3076      223    3    3  3  3  3  3  3  3  3 
 3077      0323   4    4  4  4  4  4  5  4  5  5 
 3078      313    3    3  3  3  3  3  3  3  3 
 3079      203    3    3  3  3  4  3  3  3  4  4 
 3080      233    3    3  3  3  3  3  3  3  3 
 3081      2123   4    4  4  4  4  4  3  3 
 3082      2133   4    4  4  4  4  4  3  3 
 3083      3023   4    4  4  4  4  4  3  3 
 3084      323    3    3  3  3  3  3  3  3  3 
 3085      220    3    3  3  3  3  3  3  3  3 
 3086      221    3    3  3  3  3  4  3  3  3 
 3087      222    3    3  3  3  3  3  3  3  3 
 3088      333    3    3  3  3  3  3  3  3  3 
 3089      0320   4    4  4  4  4  3  4  3 
 3090      0321   4    4  4  4  4  4  5  4  4  4 
 3091      0322   4    4  4  4  4  4  3  3 
 3092      310    3    3  3  4  4  3  4  3  3  4  4 
 3093      311    3    3  3  3  3  3  3  3  4  4 
 3094      312    3    3  3  3  3  4  3  3  4  4 
 3095      200    3    3  3  3  3  3  4  3  3 
 3096      201    3    3  3  3  4  3  4  3  4  4 
 3097      202    3    3  3  3  3  3  3  3  3 
 3098      230    3    3  3  3  4  3  3  3  4  4 
 3099      231    3    3  3  3  4  4  3  3  4  4 
 3100      232    3    3  3  3  3  3  3  3  3 
 3101      2120   4    4  4  4  4  3  4  3 
 3102      2121   4    4  4  4  4  4  4  4  4 
 3103      2122   4    4  4  4  3  3  3 
 3104      2130   4    4  4  4  4  4  4  4  4  4 
 3105      2131   4    4  4  4  4  4  4  4  4  4 
 3106      2132   4    4  4  4  4  4  3  3 
 3107      3020   4    4  4  4  4  4  4  4  4  4 
 3108      3021   4    4  4  4  4  4  4  4  4  4 
 3109      3022   4    4  4  4  4  4  3  3 
 3110      320    3    3  3  3  4  4  3  3  4  4 
 3111      321    3    3  3  3  3  4  3  3  4  4 
 3112      322    3    3  3  3  3  3  3  3  3 
 3113      330    3    3  3  3  3  3  4  3  3 
 3114      331    3    3  3  3  3  3  3  3  3 
 3115      332    3    3  3  3  3  3  3  3  3 
